1 1 1 1 1 1 1 1 1 1 1 1 1 1 1 1 1 1 1 1 1 1 1 1 1 1 1 1 1 1
1 2 0 0 0 0 0 0 0 0 0 1 1 0 0 0 11 1 0 0 0 0 0 0 0 0 0 0 0 1
1 0 0 0 0 8 0 0 0 0 0 1 1 5 0 0 0 1 0 0 0 0 0 4 0 0 0 0 0 1
1 1 1 1 0 0 0 1 1 0 0 1 1 0 0 0 7 1 0 0 1 1 1 1 1 1 1 0 0 1
1 0 0 0 0 0 0 1 1 4 0 1 1 0 0 0 0 1 0 0 0 0 1 0 0 4 0 0 0 1
1 0 0 0 0 0 0 1 1 0 0 0 0 0 0 0 0 0 0 0 0 0 1 0 0 0 0 0 0 1
1 0 0 0 0 0 0 1 1 0 0 8 0 0 0 0 0 10 0 0 0 0 1 0 0 1 1 1 1 1
1 0 0 1 1 1 1 1 1 0 0 0 0 1 1 1 1 1 1 1 0 0 0 0 0 0 0 1 1 1
1 0 10 0 0 0 0 4 0 0 0 0 0 1 1 0 4 0 0 0 0 0 0 0 0 0 0 1 1 1
1 0 0 0 0 0 0 0 0 0 0 0 0 1 1 0 0 0 0 0 0 0 1 1 1 0 0 1 1 1
1 0 0 0 0 0 0 0 1 1 1 1 1 1 1 0 0 0 0 0 0 0 1 0 0 0 0 0 0 1
1 0 0 0 0 9 0 0 1 0 0 0 0 5 0 0 0 0 0 1 1 1 1 5 0 0 0 0 0 1
1 1 1 1 0 0 0 0 1 0 0 0 0 0 0 0 0 1 1 1 0 0 0 0 0 0 0 0 0 1
1 1 1 1 0 0 0 0 1 0 0 0 0 0 0 0 0 0 0 1 0 0 0 0 0 0 0 0 0 1
1 0 0 0 0 8 0 0 1 0 0 1 1 1 1 1 1 0 0 1 4 0 0 1 1 1 1 1 0 1
1 0 0 1 1 1 1 1 1 0 0 1 1 1 1 1 1 4 0 1 0 0 1 1 10 0 0 0 0 1
1 4 0 1 0 0 0 6 0 0 0 0 7 0 0 0 0 0 0 1 0 0 0 0 0 1 1 1 0 1
1 0 0 1 0 9 0 0 0 0 0 0 0 0 0 0 1 0 0 1 0 0 0 0 0 1 0 0 0 1
1 0 0 0 0 0 0 0 0 5 0 0 0 0 0 0 1 0 0 1 0 0 1 0 0 0 4 0 3 1
1 1 1 1 1 1 1 1 1 1 1 1 1 1 1 1 1 1 1 1 1 1 1 1 1 1 1 1 1 1
13 15 1 5 1
19 27 1 2 0
9 10 2 7 2
23 27 4 5 3
3 8 8 9 1
15 19 8 10 2
9 14 11 13 1
23 26 10 13 2
20 21 13 17 0
17 18 14 18 1
1 2 15 18 3
4 8 16 16 2
5 12 17 18 3
24 27 18 18 2